#####                   ###
#####                   ###
#####@                  ###
#####        ...        ###
##########          #######
#####                   ###